111111111111
100000000P01
100000000001
1000E0000001
1000000000C1
111111111111