11111111
1C001001
100C1001
1E101001
10000001
1000P001
11111111
